File,% covered,Lines,Relevant Lines,Lines covered,Lines missed
"./app/controllers/admin_messages_controller.rb",95,260,167,159,8
"./app/controllers/admin_views_controller.rb",94,460,295,278,17
"./app/controllers/announcements_controller.rb",97,131,73,71,2
"./app/controllers/application_controller.rb",85,1139,554,472,82
"./app/controllers/articles_controller.rb",90,326,162,146,16
"./app/controllers/bulk_matches_controller.rb",93,320,218,203,15
"./app/controllers/calendar_settings_controller.rb",100,11,5,5,0
"./app/controllers/chronus_sessions_controller.rb",100,28,13,13,0
"./app/controllers/coaching_goal_activities_controller.rb",100,37,22,22,0
"./app/controllers/coaching_goals_controller.rb",96,103,56,54,2
"./app/controllers/comments_controller.rb",100,23,15,15,0
"./app/controllers/confidentiality_audit_logs_controller.rb",100,37,25,25,0
"./app/controllers/connection/memberships_controller.rb",100,23,12,12,0
"./app/controllers/connection/milestones_controller.rb",100,98,62,62,0
"./app/controllers/connection/private_notes_controller.rb",97,84,39,38,1
"./app/controllers/connection/questions_controller.rb",100,52,28,28,0
"./app/controllers/connection/tasks_controller.rb",100,66,42,42,0
"./app/controllers/contact_admin_settings_controller.rb",100,28,17,17,0
"./app/controllers/coverages_controller.rb",40,10,5,2,3
"./app/controllers/customized_terms_controller.rb",100,22,14,14,0
"./app/controllers/data_imports_controller.rb",100,18,10,10,0
"./app/controllers/facilitate_users_controller.rb",100,87,45,45,0
"./app/controllers/facilitation_messages_controller.rb",100,78,41,41,0
"./app/controllers/feedbacks_controller.rb",100,30,14,14,0
"./app/controllers/flags_controller.rb",98,84,56,55,1
"./app/controllers/forums_controller.rb",100,83,50,50,0
"./app/controllers/four_oh_fours_controller.rb",45,26,11,5,6
"./app/controllers/group_views_controller.rb",100,78,50,50,0
"./app/controllers/groups_controller.rb",95,1357,821,778,43
"./app/controllers/handbooks_controller.rb",100,36,22,22,0
"./app/controllers/home_controller.rb",54,140,76,41,35
"./app/controllers/incoming_mails_controller.rb",99,112,68,67,1
"./app/controllers/linkedin_import_controller.rb",95,204,126,120,6
"./app/controllers/locations_controller.rb",100,15,8,8,0
"./app/controllers/mailer_templates_controller.rb",100,115,73,73,0
"./app/controllers/mailer_widgets_controller.rb",100,60,37,37,0
"./app/controllers/mailgun_webhook_handlers_controller.rb",100,48,24,24,0
"./app/controllers/match_configs_controller.rb",95,132,83,79,4
"./app/controllers/meeting_requests_controller.rb",88,186,116,102,14
"./app/controllers/meetings_controller.rb",97,506,327,317,10
"./app/controllers/members_controller.rb",93,838,483,450,33
"./app/controllers/membership_questions_controller.rb",95,63,39,37,2
"./app/controllers/membership_request/instructions_controller.rb",100,23,13,13,0
"./app/controllers/membership_requests_controller.rb",96,306,203,195,8
"./app/controllers/mentor_offers_controller.rb",96,102,68,65,3
"./app/controllers/mentor_request/instructions_controller.rb",100,24,14,14,0
"./app/controllers/mentor_requests_controller.rb",91,389,234,213,21
"./app/controllers/mentoring_model/facilitation_templates_controller.rb",100,80,47,47,0
"./app/controllers/mentoring_model/goal_templates_controller.rb",100,38,22,22,0
"./app/controllers/mentoring_model/goals_controller.rb",100,81,47,47,0
"./app/controllers/mentoring_model/milestone_templates_controller.rb",100,42,22,22,0
"./app/controllers/mentoring_model/milestones_controller.rb",94,53,32,30,2
"./app/controllers/mentoring_model/task/comments_controller.rb",100,35,24,24,0
"./app/controllers/mentoring_model/task_templates_controller.rb",98,182,113,111,2
"./app/controllers/mentoring_model/tasks_controller.rb",95,247,149,142,7
"./app/controllers/mentoring_models_controller.rb",100,289,166,166,0
"./app/controllers/mentoring_slots_controller.rb",99,110,73,72,1
"./app/controllers/mentoring_template/milestones_controller.rb",100,87,50,50,0
"./app/controllers/mentoring_template/tasks_controller.rb",100,37,22,22,0
"./app/controllers/mentoring_tips_controller.rb",100,47,26,26,0
"./app/controllers/messages_controller.rb",87,129,69,60,9
"./app/controllers/organization_admins_controller.rb",100,65,38,38,0
"./app/controllers/organizations_controller.rb",95,245,130,123,7
"./app/controllers/pages_controller.rb",97,146,72,70,2
"./app/controllers/passwords_controller.rb",95,151,86,82,4
"./app/controllers/posts_controller.rb",91,93,57,52,5
"./app/controllers/profile_pictures_controller.rb",100,55,28,28,0
"./app/controllers/profile_questions_controller.rb",81,203,130,105,25
"./app/controllers/program_events_controller.rb",90,303,200,180,20
"./app/controllers/program_invitations_controller.rb",96,147,76,73,3
"./app/controllers/programs_controller.rb",92,684,367,337,30
"./app/controllers/project_requests_controller.rb",98,230,143,140,3
"./app/controllers/qa_answers_controller.rb",100,34,22,22,0
"./app/controllers/qa_questions_controller.rb",99,112,69,68,1
"./app/controllers/registrations_controller.rb",98,313,184,180,4
"./app/controllers/report/alerts_controller.rb",100,60,35,35,0
"./app/controllers/report/metrics_controller.rb",100,91,59,59,0
"./app/controllers/report/sections_controller.rb",100,54,29,29,0
"./app/controllers/reports_controller.rb",91,394,242,220,22
"./app/controllers/resources_controller.rb",98,181,106,104,2
"./app/controllers/role_questions_controller.rb",100,79,54,54,0
"./app/controllers/scraps_controller.rb",100,102,65,65,0
"./app/controllers/sections_controller.rb",100,60,31,31,0
"./app/controllers/sessions_controller.rb",95,404,240,229,11
"./app/controllers/survey_questions_controller.rb",100,63,36,36,0
"./app/controllers/surveys_controller.rb",85,316,193,165,28
"./app/controllers/tasks_controller.rb",100,55,28,28,0
"./app/controllers/themes_controller.rb",62,138,82,51,31
"./app/controllers/three_sixty/common_controller.rb",100,19,11,11,0
"./app/controllers/three_sixty/competencies_controller.rb",100,39,22,22,0
"./app/controllers/three_sixty/questions_controller.rb",100,32,17,17,0
"./app/controllers/three_sixty/reviewer_groups_controller.rb",100,34,19,19,0
"./app/controllers/three_sixty/survey_assessees_controller.rb",72,125,82,59,23
"./app/controllers/three_sixty/survey_competencies_controller.rb",100,32,19,19,0
"./app/controllers/three_sixty/survey_questions_controller.rb",100,40,25,25,0
"./app/controllers/three_sixty/survey_reviewers_controller.rb",100,128,78,78,0
"./app/controllers/three_sixty/surveys_controller.rb",100,161,99,99,0
"./app/controllers/topics_controller.rb",95,101,60,57,3
"./app/controllers/user_favorites_controller.rb",100,14,8,8,0
"./app/controllers/users_controller.rb",96,1199,673,645,28
"./app/controllers/zencoder_callback_controller.rb",100,48,23,23,0
"./app/helpers/admin_messages_helper.rb",82,155,83,68,15
"./app/helpers/admin_views_helper.rb",82,872,444,366,78
"./app/helpers/aggregated_mail_helper.rb",88,290,162,142,20
"./app/helpers/analytics_helper.rb",100,51,20,20,0
"./app/helpers/announcements_helper.rb",100,11,6,6,0
"./app/helpers/app_constants_helper.rb",100,121,53,53,0
"./app/helpers/application_helper.rb",94,1713,782,734,48
"./app/helpers/articles_helper.rb",93,253,113,105,8
"./app/helpers/bulk_match_helper.rb",100,104,44,44,0
"./app/helpers/coaching_goal_activities_helper.rb",100,9,5,5,0
"./app/helpers/coaching_goals_helper.rb",96,110,50,48,2
"./app/helpers/common_answers_helper.rb",95,272,133,127,6
"./app/helpers/common_questions_helper.rb",98,110,59,58,1
"./app/helpers/confidentiality_audit_logs_helper.rb",100,9,5,5,0
"./app/helpers/connection/milestones_helper.rb",76,213,120,91,29
"./app/helpers/connection/tasks_helper.rb",100,5,3,3,0
"./app/helpers/data_imports_helper.rb",88,36,17,15,2
"./app/helpers/demographic_report_helper.rb",100,56,30,30,0
"./app/helpers/educations_helper.rb",100,46,23,23,0
"./app/helpers/experiences_helper.rb",100,51,26,26,0
"./app/helpers/facilitate_users_helper.rb",100,10,5,5,0
"./app/helpers/facilitation_messages_helper.rb",100,32,12,12,0
"./app/helpers/feedbacks_helper.rb",94,31,17,16,1
"./app/helpers/flags_helper.rb",81,132,77,62,15
"./app/helpers/group_views_helper.rb",76,477,279,213,66
"./app/helpers/groups_helper.rb",92,1015,522,482,40
"./app/helpers/groups_report_helper.rb",100,142,71,71,0
"./app/helpers/hand_books_helper.rb",100,5,3,3,0
"./app/helpers/health_reports_helper.rb",97,259,118,114,4
"./app/helpers/home_helper.rb",12,25,17,2,15
"./app/helpers/mailer_templates_helper.rb",100,15,9,9,0
"./app/helpers/managers_helper.rb",100,15,8,8,0
"./app/helpers/match_configs_helper.rb",83,55,24,20,4
"./app/helpers/meeting_requests_helper.rb",100,62,39,39,0
"./app/helpers/meetings_helper.rb",97,223,126,122,4
"./app/helpers/members_helper.rb",89,244,133,119,14
"./app/helpers/membership_requests_helper.rb",92,221,127,117,10
"./app/helpers/mentor_requests_helper.rb",93,108,55,51,4
"./app/helpers/mentoring_model/goal_template_helper.rb",100,7,3,3,0
"./app/helpers/mentoring_model/goals_helper.rb",100,21,11,11,0
"./app/helpers/mentoring_model/milestone_templates_helper.rb",100,5,3,3,0
"./app/helpers/mentoring_model/milestones_helper.rb",100,112,65,65,0
"./app/helpers/mentoring_model/task_templates_helper.rb",67,34,21,14,7
"./app/helpers/mentoring_model/tasks_helper.rb",100,127,67,67,0
"./app/helpers/mentoring_models_helper.rb",100,210,111,111,0
"./app/helpers/mentoring_slots_helper.rb",84,72,38,32,6
"./app/helpers/mentoring_template/milestones_helper.rb",100,3,2,2,0
"./app/helpers/mentoring_template/tasks_helper.rb",100,12,8,8,0
"./app/helpers/messages_helper.rb",91,170,99,90,9
"./app/helpers/organizations_helper.rb",84,183,101,85,16
"./app/helpers/pages_helper.rb",95,37,21,20,1
"./app/helpers/profile_answers_helper.rb",81,399,227,184,43
"./app/helpers/profile_picture_helper.rb",100,11,3,3,0
"./app/helpers/profile_questions_helper.rb",69,427,239,166,73
"./app/helpers/program_events_helper.rb",98,177,93,91,2
"./app/helpers/program_invitations_helper.rb",97,68,37,36,1
"./app/helpers/programs_helper.rb",98,384,212,208,4
"./app/helpers/project_requests_helper.rb",100,83,44,44,0
"./app/helpers/publications_helper.rb",100,32,20,20,0
"./app/helpers/qa_answers_helper.rb",100,22,11,11,0
"./app/helpers/qa_questions_helper.rb",100,13,6,6,0
"./app/helpers/recent_activity_helper.rb",87,851,439,382,57
"./app/helpers/registrations_helper.rb",100,12,10,10,0
"./app/helpers/report/metrics_helper.rb",93,30,15,14,1
"./app/helpers/reports_helper.rb",97,62,36,35,1
"./app/helpers/resources_helper.rb",100,26,16,16,0
"./app/helpers/role_questions_helper.rb",97,70,38,37,1
"./app/helpers/scraps_helper.rb",100,34,13,13,0
"./app/helpers/search_helper.rb",100,221,91,91,0
"./app/helpers/secure_urls_helper.rb",100,14,5,5,0
"./app/helpers/surveys_helper.rb",89,87,45,40,5
"./app/helpers/tasks_helper.rb",96,58,28,27,1
"./app/helpers/three_sixty/competencies_helper.rb",100,61,35,35,0
"./app/helpers/three_sixty/survey_assessees_helper.rb",98,102,66,65,1
"./app/helpers/three_sixty/surveys_helper.rb",100,202,99,99,0
"./app/helpers/topics_helper.rb",100,20,14,14,0
"./app/helpers/user_favorites_helper.rb",76,31,17,13,4
"./app/helpers/user_mailer_helper.rb",88,294,134,118,16
"./app/helpers/users_helper.rb",97,1304,715,692,23
"./app/mailers/chronus_mailer.rb",90,177,84,76,8
"./app/mailers/internal_mailer.rb",94,129,88,83,5
"./app/mailers/lib/email_customization.rb",100,43,21,21,0
"./app/mailers/lib/mailer.rb",100,321,184,184,0
"./app/mailers/lib/mailer_tag.rb",100,9,5,5,0
"./app/mailers/lib/widget_tag.rb",99,116,72,71,1
"./app/mailers/mailer_extensions/setup.rb",98,107,62,61,1
"./app/mailers/mails/add_role_membership_request_accepted.rb",96,51,26,25,1
"./app/mailers/mails/add_role_membership_request_not_accepted.rb",100,42,22,22,0
"./app/mailers/mails/admin_added_directly_notification.rb",100,45,24,24,0
"./app/mailers/mails/admin_added_notification.rb",100,48,27,27,0
"./app/mailers/mails/admin_pending_membership_requests.rb",100,40,23,23,0
"./app/mailers/mails/admin_weekly_status.rb",100,84,44,44,0
"./app/mailers/mails/aggregated_mail.rb",100,41,22,22,0
"./app/mailers/mails/aggregated_member_mail.rb",100,41,22,22,0
"./app/mailers/mails/announcement_notification.rb",100,50,28,28,0
"./app/mailers/mails/announcement_test_notification.rb",100,41,23,23,0
"./app/mailers/mails/announcement_update_notification.rb",96,50,28,27,1
"./app/mailers/mails/article_comment_notification.rb",100,58,32,32,0
"./app/mailers/mails/auto_email_notification.rb",100,57,34,34,0
"./app/mailers/mails/campaign_email_notification.rb",97,50,35,34,1
"./app/mailers/mails/content_flagged_admin_notification.rb",82,93,49,40,9
"./app/mailers/mails/content_moderation_admin_notification.rb",94,62,33,31,2
"./app/mailers/mails/content_moderation_user_notification.rb",96,50,27,26,1
"./app/mailers/mails/demotion_notification.rb",100,53,30,30,0
"./app/mailers/mails/direct_join_membership_request_accepted.rb",100,45,24,24,0
"./app/mailers/mails/email_change_notification.rb",100,47,26,26,0
"./app/mailers/mails/forgot_password.rb",100,38,22,22,0
"./app/mailers/mails/forum_notification.rb",96,51,27,26,1
"./app/mailers/mails/group_creation_notification_to_custom_users.rb",100,59,33,33,0
"./app/mailers/mails/group_creation_notification_to_mentor.rb",100,71,40,40,0
"./app/mailers/mails/group_creation_notification_to_students.rb",100,65,36,36,0
"./app/mailers/mails/group_inactivity_notification.rb",100,53,30,30,0
"./app/mailers/mails/group_inactivity_notification_with_auto_terminate.rb",100,53,30,30,0
"./app/mailers/mails/group_member_addition_notification_to_new_member.rb",95,73,41,39,2
"./app/mailers/mails/group_member_removal_notification_to_removed_member.rb",94,62,36,34,2
"./app/mailers/mails/group_mentoring_offer_added_notification_to_new_mentee.rb",97,57,31,30,1
"./app/mailers/mails/group_mentoring_offer_notification_to_new_mentee.rb",96,49,27,26,1
"./app/mailers/mails/group_owner_addition_notification.rb",100,41,22,22,0
"./app/mailers/mails/group_proposed_notification_to_admins.rb",100,49,28,28,0
"./app/mailers/mails/group_published_notification.rb",100,51,28,28,0
"./app/mailers/mails/group_reactivation_notification.rb",100,56,31,31,0
"./app/mailers/mails/group_termination_notification_by_admin.rb",94,59,31,29,2
"./app/mailers/mails/group_termination_notification_on_expiry.rb",100,47,26,26,0
"./app/mailers/mails/group_termination_notification_on_inactivity.rb",100,45,24,24,0
"./app/mailers/mails/group_termination_notification_on_leaving.rb",100,55,30,30,0
"./app/mailers/mails/invite_expiry_notification.rb",96,54,26,25,1
"./app/mailers/mails/invite_expiry_notification_without_roles.rb",96,48,24,23,1
"./app/mailers/mails/invite_notification.rb",100,56,28,28,0
"./app/mailers/mails/invite_notification_from_admin.rb",100,54,26,26,0
"./app/mailers/mails/invite_notification_without_roles.rb",100,51,29,29,0
"./app/mailers/mails/manager_notification.rb",100,46,24,24,0
"./app/mailers/mails/meeting_cancellation_notification.rb",100,37,22,22,0
"./app/mailers/mails/meeting_creation_notification.rb",96,41,23,22,1
"./app/mailers/mails/meeting_creation_notification_to_owner.rb",100,34,19,19,0
"./app/mailers/mails/meeting_edit_notification.rb",96,43,25,24,1
"./app/mailers/mails/meeting_feedback_request.rb",100,50,29,29,0
"./app/mailers/mails/meeting_reminder.rb",100,35,20,20,0
"./app/mailers/mails/meeting_request_closed_for_recipient.rb",43,48,28,12,16
"./app/mailers/mails/meeting_request_closed_for_sender.rb",96,48,28,27,1
"./app/mailers/mails/meeting_request_created_notification.rb",92,45,26,24,2
"./app/mailers/mails/meeting_request_created_notification_non_calendar.rb",92,44,25,23,2
"./app/mailers/mails/meeting_request_expired_notification_to_sender.rb",97,50,29,28,1
"./app/mailers/mails/meeting_request_reminder_notification.rb",100,49,28,28,0
"./app/mailers/mails/meeting_request_sent_notification.rb",92,45,26,24,2
"./app/mailers/mails/meeting_request_sent_notification_non_calendar.rb",92,43,24,22,2
"./app/mailers/mails/meeting_request_status_accepted_notification.rb",93,46,27,25,2
"./app/mailers/mails/meeting_request_status_accepted_notification_non_calendar.rb",92,45,26,24,2
"./app/mailers/mails/meeting_request_status_accepted_notification_non_calendar_to_self.rb",93,46,27,25,2
"./app/mailers/mails/meeting_request_status_accepted_notification_to_self.rb",93,46,28,26,2
"./app/mailers/mails/meeting_request_status_declined_notification.rb",93,46,27,25,2
"./app/mailers/mails/meeting_request_status_declined_notification_non_calendar.rb",42,45,26,11,15
"./app/mailers/mails/meeting_request_status_declined_notification_non_calendar_to_self.rb",41,46,27,11,16
"./app/mailers/mails/meeting_request_status_declined_notification_to_self.rb",93,46,28,26,2
"./app/mailers/mails/meeting_request_status_withdrawn_notification.rb",93,46,27,25,2
"./app/mailers/mails/meeting_request_status_withdrawn_notification_non_calendar.rb",92,45,26,24,2
"./app/mailers/mails/meeting_request_status_withdrawn_notification_non_calendar_to_self.rb",93,46,27,25,2
"./app/mailers/mails/meeting_request_status_withdrawn_notification_to_self.rb",93,46,28,26,2
"./app/mailers/mails/meeting_rsvp_notification.rb",100,45,26,26,0
"./app/mailers/mails/member_activation_notification.rb",100,38,22,22,0
"./app/mailers/mails/member_imported_notification.rb",96,50,28,27,1
"./app/mailers/mails/member_suspension_notification.rb",96,45,25,24,1
"./app/mailers/mails/membership_request_accepted.rb",100,52,28,28,0
"./app/mailers/mails/membership_request_not_accepted.rb",100,40,21,21,0
"./app/mailers/mails/membership_request_sent_notification.rb",100,30,16,16,0
"./app/mailers/mails/membership_requests_export.rb",100,30,18,18,0
"./app/mailers/mails/mentee_added_notification.rb",100,45,24,24,0
"./app/mailers/mails/mentee_added_notification_to_review_profile.rb",100,43,24,24,0
"./app/mailers/mails/mentor_added_notification.rb",100,43,24,24,0
"./app/mailers/mails/mentor_added_notification_to_review_profile.rb",100,43,24,24,0
"./app/mailers/mails/mentor_mentee_added_notification.rb",100,43,24,24,0
"./app/mailers/mails/mentor_mentee_added_notification_to_review_profile.rb",100,43,24,24,0
"./app/mailers/mails/mentor_offer_accepted_notification_to_mentor.rb",96,52,28,27,1
"./app/mailers/mails/mentor_offer_rejected_notification_to_mentor.rb",96,47,25,24,1
"./app/mailers/mails/mentor_request_accepted.rb",100,52,29,29,0
"./app/mailers/mails/mentor_request_closed_for_recipient.rb",100,50,29,29,0
"./app/mailers/mails/mentor_request_closed_for_sender.rb",100,50,29,29,0
"./app/mailers/mails/mentor_request_expired_to_sender.rb",97,50,29,28,1
"./app/mailers/mails/mentor_request_rejected.rb",100,56,32,32,0
"./app/mailers/mails/mentor_request_reminder_notification.rb",100,50,29,29,0
"./app/mailers/mails/mentor_request_withdrawn.rb",100,43,24,24,0
"./app/mailers/mails/mentor_request_withdrawn_to_admin.rb",100,42,23,23,0
"./app/mailers/mails/mentor_requests_export.rb",100,31,18,18,0
"./app/mailers/mails/mentoring_area_digest.rb",100,67,40,40,0
"./app/mailers/mails/mentoring_area_export.rb",100,38,22,22,0
"./app/mailers/mails/new_admin_message_notification.rb",100,77,47,47,0
"./app/mailers/mails/new_admin_message_notification_to_member.rb",100,63,38,38,0
"./app/mailers/mails/new_article_notification.rb",100,51,28,28,0
"./app/mailers/mails/new_mentor_request.rb",100,44,25,25,0
"./app/mailers/mails/new_mentor_request_to_admin.rb",100,43,24,24,0
"./app/mailers/mails/new_message_notification.rb",100,62,39,39,0
"./app/mailers/mails/new_message_to_offline_user_notification.rb",100,54,32,32,0
"./app/mailers/mails/new_program_event_notification.rb",98,75,42,41,1
"./app/mailers/mails/new_program_event_test_notification.rb",92,68,39,36,3
"./app/mailers/mails/new_project_request_to_admin_and_owner.rb",100,52,29,29,0
"./app/mailers/mails/password_expiry_notification.rb",100,36,21,21,0
"./app/mailers/mails/pending_group_added_notification.rb",100,56,31,31,0
"./app/mailers/mails/pending_group_removed_notification.rb",100,47,26,26,0
"./app/mailers/mails/posting_in_mentoring_area_failure.rb",100,60,33,33,0
"./app/mailers/mails/program_event_delete_notification.rb",100,45,26,26,0
"./app/mailers/mails/program_event_reminder_notification.rb",93,69,40,37,3
"./app/mailers/mails/program_event_update_notification.rb",98,75,42,41,1
"./app/mailers/mails/program_event_update_test_notification.rb",90,68,39,35,4
"./app/mailers/mails/project_request_accepted.rb",100,46,26,26,0
"./app/mailers/mails/project_request_rejected.rb",100,50,28,28,0
"./app/mailers/mails/project_request_reminder_notification.rb",100,56,32,32,0
"./app/mailers/mails/promotion_notification.rb",100,68,37,37,0
"./app/mailers/mails/proposed_project_accepted.rb",100,54,29,29,0
"./app/mailers/mails/proposed_project_rejected.rb",96,46,26,25,1
"./app/mailers/mails/qa_answer_notification.rb",100,57,31,31,0
"./app/mailers/mails/reactivate_account.rb",100,40,23,23,0
"./app/mailers/mails/reply_to_admin_message_failure_notification.rb",100,52,30,30,0
"./app/mailers/mails/reply_to_admin_message_notification.rb",98,75,44,43,1
"./app/mailers/mails/reply_to_message_notification.rb",100,63,39,39,0
"./app/mailers/mails/report_alert.rb",100,41,25,25,0
"./app/mailers/mails/resend_signup_instructions.rb",100,35,20,20,0
"./app/mailers/mails/scrap_notification_within_reply.rb",97,65,38,37,1
"./app/mailers/mails/three_sixty_survey_assessee_notification.rb",97,52,29,28,1
"./app/mailers/mails/three_sixty_survey_reviewer_notification.rb",93,52,29,27,2
"./app/mailers/mails/user_activation_notification.rb",95,38,21,20,1
"./app/mailers/mails/user_suspension_notification.rb",96,46,25,24,1
"./app/mailers/mails/user_with_set_of_roles_added_notification.rb",100,47,27,27,0
"./app/mailers/mails/user_with_set_of_roles_added_notification_to_review_profile.rb",100,48,27,27,0
"./app/mailers/mails/weekly_updates.rb",100,56,36,36,0
"./app/mailers/mails/welcome_message_to_admin.rb",83,59,30,25,5
"./app/mailers/mails/welcome_message_to_mentee.rb",100,39,20,20,0
"./app/mailers/mails/welcome_message_to_mentor.rb",100,38,20,20,0
"./app/mailers/tags/campaign_tags.rb",62,96,52,32,20
"./app/mailers/tags/constant_tags.rb",100,5,3,3,0
"./app/mailers/tags/customized_terms_tags.rb",84,126,63,53,10
"./app/mailers/tags/global_tags.rb",100,20,12,12,0
"./app/mailers/tags/meeting_request_tags.rb",78,34,18,14,4
"./app/mailers/tags/meeting_tags.rb",98,106,62,61,1
"./app/mailers/tags/message_tags.rb",85,25,13,11,2
"./app/mailers/tags/subprogram_tags.rb",100,25,13,13,0
"./app/mailers/widgets/widget_signature.rb",100,21,8,8,0
"./app/mailers/widgets/widget_styles.rb",100,19,8,8,0
"./app/models/abstract_instruction.rb",100,18,4,4,0
"./app/models/abstract_message.rb",98,274,116,114,2
"./app/models/abstract_message_observer.rb",97,63,34,33,1
"./app/models/abstract_message_receiver.rb",100,77,32,32,0
"./app/models/abstract_program.rb",100,602,234,234,0
"./app/models/abstract_request.rb",100,146,54,54,0
"./app/models/abstract_view.rb",99,162,87,86,1
"./app/models/activity_log.rb",100,51,26,26,0
"./app/models/admin_message.rb",98,358,131,129,2
"./app/models/admin_message_observer.rb",100,46,25,25,0
"./app/models/admin_messages/receiver.rb",100,71,33,33,0
"./app/models/admin_messages/receiver_observer.rb",100,7,3,3,0
"./app/models/admin_view.rb",90,1253,718,644,74
"./app/models/admin_view_column.rb",95,400,193,183,10
"./app/models/admin_view_observer.rb",100,9,6,6,0
"./app/models/announcement.rb",100,112,47,47,0
"./app/models/announcement_observer.rb",100,44,19,19,0
"./app/models/article.rb",99,279,93,92,1
"./app/models/article/publication.rb",100,107,31,31,0
"./app/models/article/publication_observer.rb",100,6,3,3,0
"./app/models/article_content.rb",98,199,80,78,2
"./app/models/article_list_item.rb",96,56,23,22,1
"./app/models/article_observer.rb",95,67,22,21,1
"./app/models/auth_config.rb",100,138,67,67,0
"./app/models/book_list_item_presenter.rb",100,63,35,35,0
"./app/models/bulk_match.rb",100,103,56,56,0
"./app/models/calendar_setting.rb",86,52,21,18,3
"./app/models/ckeditor/asset.rb",100,25,4,4,0
"./app/models/ckeditor/attachment_file.rb",83,30,6,5,1
"./app/models/ckeditor/picture.rb",86,31,7,6,1
"./app/models/coaching_goal.rb",100,72,28,28,0
"./app/models/coaching_goal_activity.rb",100,34,12,12,0
"./app/models/coaching_goal_activity_observer.rb",100,30,15,15,0
"./app/models/coaching_goal_observer.rb",100,37,17,17,0
"./app/models/comment.rb",100,66,20,20,0
"./app/models/comment_observer.rb",100,14,4,4,0
"./app/models/common_answer.rb",93,191,85,79,6
"./app/models/common_answer_observer.rb",100,7,4,4,0
"./app/models/common_question.rb",100,113,44,44,0
"./app/models/common_question_observer.rb",93,56,28,26,2
"./app/models/confidentiality_audit_log.rb",100,30,10,10,0
"./app/models/connection/activity.rb",100,135,33,33,0
"./app/models/connection/answer.rb",100,47,14,14,0
"./app/models/connection/custom_membership.rb",100,7,4,4,0
"./app/models/connection/membership.rb",99,303,136,134,2
"./app/models/connection/mentee_membership.rb",100,26,4,4,0
"./app/models/connection/mentor_membership.rb",100,26,4,4,0
"./app/models/connection/milestone.rb",97,135,67,65,2
"./app/models/connection/milestone_observer.rb",100,51,26,26,0
"./app/models/connection/private_note.rb",100,104,19,19,0
"./app/models/connection/question.rb",100,36,5,5,0
"./app/models/connection/task.rb",100,67,31,31,0
"./app/models/connection/task_observer.rb",100,37,20,20,0
"./app/models/contact_admin_setting.rb",100,17,3,3,0
"./app/models/customized_term.rb",97,51,39,38,1
"./app/models/data_import.rb",100,38,12,12,0
"./app/models/display_mentoring_session_report.rb",100,25,18,18,0
"./app/models/education.rb",93,54,14,13,1
"./app/models/education_observer.rb",100,13,9,9,0
"./app/models/email_tracker.rb",100,74,58,58,0
"./app/models/engagement_survey.rb",100,9,3,3,0
"./app/models/event_invite.rb",100,43,19,19,0
"./app/models/event_invite_observer.rb",100,35,17,17,0
"./app/models/experience.rb",96,81,27,26,1
"./app/models/experience_observer.rb",100,13,9,9,0
"./app/models/facilitate_user.rb",100,155,71,71,0
"./app/models/facilitation_delivery_log.rb",100,42,18,18,0
"./app/models/facilitation_message.rb",100,121,40,40,0
"./app/models/facilitation_message/template_builder.rb",100,199,27,27,0
"./app/models/feature.rb",100,49,19,19,0
"./app/models/feed_exporter.rb",75,166,92,69,23
"./app/models/feed_exporter_observer.rb",75,9,4,3,1
"./app/models/feedback.rb",100,29,8,8,0
"./app/models/feedback/answer.rb",88,60,8,7,1
"./app/models/feedback/form.rb",92,65,13,12,1
"./app/models/feedback/question.rb",50,65,10,5,5
"./app/models/feedback/response.rb",55,83,20,11,9
"./app/models/feedback/response_list_for_mentor.rb",44,25,9,4,5
"./app/models/filter_views/admin_message_view.rb",100,23,14,14,0
"./app/models/filter_views/connection_view.rb",100,58,29,29,0
"./app/models/filter_views/flag_view.rb",100,32,20,20,0
"./app/models/filter_views/meeting_request_view.rb",100,29,17,17,0
"./app/models/filter_views/membership_request_view.rb",100,30,18,18,0
"./app/models/filter_views/mentor_request_view.rb",100,67,34,34,0
"./app/models/filter_views/program_invitation_view.rb",100,27,16,16,0
"./app/models/filter_views/project_request_view.rb",100,66,33,33,0
"./app/models/flag.rb",100,105,50,50,0
"./app/models/flag_observer.rb",100,11,5,5,0
"./app/models/forum.rb",100,84,37,37,0
"./app/models/four_oh_four.rb",100,25,6,6,0
"./app/models/group.rb",100,1341,617,615,2
"./app/models/group/membership_setting.rb",100,38,15,15,0
"./app/models/group/mentoring_model_cloner.rb",100,197,131,131,0
"./app/models/group/mentoring_model_updater.rb",98,263,170,166,4
"./app/models/group_closure_reason.rb",100,32,15,15,0
"./app/models/group_observer.rb",99,267,154,153,1
"./app/models/group_state_change.rb",100,7,5,5,0
"./app/models/group_view.rb",100,71,38,38,0
"./app/models/group_view_column.rb",99,433,147,145,2
"./app/models/handbook.rb",100,49,20,20,0
"./app/models/handbook_observer.rb",100,10,4,4,0
"./app/models/job_log.rb",96,148,72,69,3
"./app/models/landing_page_redirector.rb",96,66,28,27,1
"./app/models/location.rb",100,81,27,27,0
"./app/models/location_observer.rb",100,10,6,6,0
"./app/models/mailer/template.rb",100,86,44,44,0
"./app/models/mailer/widget.rb",100,49,21,21,0
"./app/models/manager.rb",100,65,25,25,0
"./app/models/manager_observer.rb",82,63,39,32,7
"./app/models/match_config.rb",93,112,45,42,3
"./app/models/max_answers_calculator.rb",100,23,11,11,0
"./app/models/meeting.rb",98,588,337,330,7
"./app/models/meeting/feedback.rb",86,27,7,6,1
"./app/models/meeting_feedback_survey.rb",67,9,3,2,1
"./app/models/meeting_observer.rb",100,49,25,25,0
"./app/models/meeting_request.rb",100,103,52,52,0
"./app/models/meeting_request_observer.rb",95,62,40,38,2
"./app/models/member.rb",98,1244,619,605,14
"./app/models/member_email_tracker.rb",100,20,3,3,0
"./app/models/member_meeting.rb",85,133,65,55,10
"./app/models/member_meeting_observer.rb",100,31,12,12,0
"./app/models/member_meeting_response.rb",100,54,23,23,0
"./app/models/member_notification.rb",100,45,8,8,0
"./app/models/member_observer.rb",100,104,51,51,0
"./app/models/membership_observer.rb",100,37,18,18,0
"./app/models/membership_request.rb",92,647,341,314,27
"./app/models/membership_request/instruction.rb",100,14,1,1,0
"./app/models/membership_request_observer.rb",100,60,33,33,0
"./app/models/mentor_offer.rb",95,113,58,55,3
"./app/models/mentor_offer_observer.rb",100,50,25,25,0
"./app/models/mentor_request.rb",100,328,150,150,0
"./app/models/mentor_request/instruction.rb",100,14,1,1,0
"./app/models/mentor_request_observer.rb",100,72,36,36,0
"./app/models/mentoring_area_scrap.rb",85,48,13,11,2
"./app/models/mentoring_model.rb",100,225,128,128,0
"./app/models/mentoring_model/cloner.rb",100,119,64,64,0
"./app/models/mentoring_model/exporter.rb",100,116,83,83,0
"./app/models/mentoring_model/facilitation_template.rb",100,66,31,31,0
"./app/models/mentoring_model/goal.rb",100,46,17,17,0
"./app/models/mentoring_model/goal_template.rb",100,21,6,6,0
"./app/models/mentoring_model/goal_template_observer.rb",100,9,5,5,0
"./app/models/mentoring_model/importer.rb",100,240,158,158,0
"./app/models/mentoring_model/link.rb",100,4,3,3,0
"./app/models/mentoring_model/milestone.rb",100,78,18,18,0
"./app/models/mentoring_model/milestone_template.rb",100,45,18,18,0
"./app/models/mentoring_model/milestone_template_observer.rb",100,9,5,5,0
"./app/models/mentoring_model/task.rb",96,180,81,78,3
"./app/models/mentoring_model/task/comment.rb",90,46,30,27,3
"./app/models/mentoring_model/task/comment_observer.rb",100,6,3,3,0
"./app/models/mentoring_model/task_observer.rb",100,23,15,15,0
"./app/models/mentoring_model/task_template.rb",100,207,102,102,0
"./app/models/mentoring_model/task_template_observer.rb",95,64,39,37,2
"./app/models/mentoring_model/v1tov2.rb",99,105,74,73,1
"./app/models/mentoring_model_observer.rb",100,20,14,14,0
"./app/models/mentoring_model_task_comment_scrap.rb",100,5,4,4,0
"./app/models/mentoring_slot.rb",88,293,150,132,18
"./app/models/mentoring_slot_observer.rb",100,8,3,3,0
"./app/models/mentoring_template.rb",100,39,17,17,0
"./app/models/mentoring_template/milestone.rb",100,98,41,41,0
"./app/models/mentoring_template/milestone_observer.rb",100,51,29,29,0
"./app/models/mentoring_template/task.rb",100,55,20,20,0
"./app/models/mentoring_template/task_observer.rb",100,51,25,25,0
"./app/models/mentoring_tip.rb",100,20,6,6,0
"./app/models/message.rb",100,124,51,51,0
"./app/models/messages/receiver.rb",100,51,19,19,0
"./app/models/mobile_device.rb",100,5,3,3,0
"./app/models/notification_setting.rb",100,19,5,5,0
"./app/models/object_permission.rb",100,42,17,17,0
"./app/models/object_role_permission.rb",100,23,6,6,0
"./app/models/organization.rb",91,505,218,198,20
"./app/models/organization_feature.rb",100,49,16,16,0
"./app/models/organization_observer.rb",100,65,42,42,0
"./app/models/page.rb",100,42,15,15,0
"./app/models/password.rb",100,38,13,13,0
"./app/models/pending_notification.rb",86,56,22,19,3
"./app/models/permission.rb",100,45,18,18,0
"./app/models/post.rb",100,78,33,33,0
"./app/models/post_observer.rb",100,44,22,22,0
"./app/models/profile_answer.rb",90,433,224,201,23
"./app/models/profile_answer_observer.rb",100,44,26,26,0
"./app/models/profile_picture.rb",98,104,41,40,1
"./app/models/profile_question.rb",98,338,188,185,3
"./app/models/profile_question/file_uploader.rb",98,76,45,44,1
"./app/models/profile_question/importer.rb",100,377,139,139,0
"./app/models/profile_question_observer.rb",100,65,33,33,0
"./app/models/profile_summary_field.rb",100,19,4,4,0
"./app/models/program.rb",96,1208,584,560,24
"./app/models/program/clone_factory.rb",98,168,90,88,2
"./app/models/program/domain.rb",100,59,23,23,0
"./app/models/program_activity.rb",100,58,14,14,0
"./app/models/program_asset.rb",100,32,9,9,0
"./app/models/program_event.rb",98,320,168,165,3
"./app/models/program_event_observer.rb",100,15,9,9,0
"./app/models/program_event_user.rb",100,4,3,3,0
"./app/models/program_invitation.rb",98,173,81,79,2
"./app/models/program_invitation_observer.rb",100,8,4,4,0
"./app/models/program_observer.rb",99,199,122,121,1
"./app/models/program_survey.rb",100,39,17,17,0
"./app/models/project_request.rb",98,114,55,54,1
"./app/models/project_request_observer.rb",94,43,18,17,1
"./app/models/publication.rb",97,94,37,36,1
"./app/models/publication_observer.rb",100,13,9,9,0
"./app/models/qa_answer.rb",100,72,34,34,0
"./app/models/qa_answer_observer.rb",100,34,17,17,0
"./app/models/qa_question.rb",100,114,42,42,0
"./app/models/qa_question_observer.rb",100,20,8,8,0
"./app/models/received_mail.rb",94,45,16,15,1
"./app/models/recent_activity.rb",100,290,92,92,0
"./app/models/report/alert.rb",91,72,43,39,4
"./app/models/report/metric.rb",100,73,37,37,0
"./app/models/report/section.rb",100,25,14,14,0
"./app/models/report_view_column.rb",91,225,95,86,9
"./app/models/request_favorite.rb",100,31,10,10,0
"./app/models/resource.rb",100,32,12,12,0
"./app/models/resource_publication.rb",100,18,11,11,0
"./app/models/role.rb",96,158,78,75,3
"./app/models/role_based_answer.rb",100,43,7,7,0
"./app/models/role_based_question.rb",90,90,30,27,3
"./app/models/role_observer.rb",100,5,3,3,0
"./app/models/role_permission.rb",100,19,6,6,0
"./app/models/role_question.rb",93,197,87,81,6
"./app/models/role_question_observer.rb",100,23,13,13,0
"./app/models/role_reference.rb",100,23,4,4,0
"./app/models/role_resource.rb",100,18,5,5,0
"./app/models/scrap.rb",95,142,61,58,3
"./app/models/scraps/receiver.rb",90,53,20,18,2
"./app/models/section.rb",97,75,31,30,1
"./app/models/security_setting.rb",100,106,46,46,0
"./app/models/subscription.rb",100,22,4,4,0
"./app/models/survey.rb",99,299,155,154,1
"./app/models/survey/clone_factory.rb",100,40,21,21,0
"./app/models/survey/importer.rb",98,98,44,43,1
"./app/models/survey_answer.rb",100,63,19,19,0
"./app/models/survey_answer_observer.rb",100,11,7,7,0
"./app/models/survey_observer.rb",100,12,6,6,0
"./app/models/survey_question.rb",100,53,13,13,0
"./app/models/survey_question_observer.rb",100,7,4,4,0
"./app/models/task.rb",100,167,59,59,0
"./app/models/task_observer.rb",100,49,26,26,0
"./app/models/theme.rb",100,35,13,13,0
"./app/models/theme_observer.rb",100,9,5,5,0
"./app/models/three_sixty/competency.rb",100,26,9,9,0
"./app/models/three_sixty/question.rb",100,51,23,23,0
"./app/models/three_sixty/reviewer_group.rb",100,67,32,32,0
"./app/models/three_sixty/survey.rb",100,158,84,84,0
"./app/models/three_sixty/survey_answer.rb",100,33,13,13,0
"./app/models/three_sixty/survey_answer_observer.rb",100,128,71,71,0
"./app/models/three_sixty/survey_assessee.rb",100,102,48,48,0
"./app/models/three_sixty/survey_assessee_competency_info.rb",100,13,8,8,0
"./app/models/three_sixty/survey_assessee_observer.rb",100,5,3,3,0
"./app/models/three_sixty/survey_assessee_question_info.rb",100,24,8,8,0
"./app/models/three_sixty/survey_competency.rb",100,48,21,21,0
"./app/models/three_sixty/survey_observer.rb",100,12,6,6,0
"./app/models/three_sixty/survey_question.rb",100,49,22,22,0
"./app/models/three_sixty/survey_reviewer.rb",100,72,34,34,0
"./app/models/three_sixty/survey_reviewer_group.rb",100,34,13,13,0
"./app/models/topic.rb",100,86,37,37,0
"./app/models/topic_observer.rb",100,5,3,3,0
"./app/models/user.rb",98,1742,935,914,21
"./app/models/user_email_tracker.rb",100,20,3,3,0
"./app/models/user_favorite.rb",100,21,4,4,0
"./app/models/user_observer.rb",95,275,141,134,7
"./app/models/user_setting.rb",100,40,13,13,0
"./app/models/user_state_change.rb",100,14,8,8,0
"./app/policies/three_sixty/add_reviewer_policy.rb",91,19,11,10,1
"./app/policies/three_sixty/survey_policy.rb",100,28,14,14,0
"./app/presenters/messages/admin_messages_presenter.rb",100,35,21,21,0
"./app/presenters/messages/base_presenter.rb",96,77,47,45,2
"./app/presenters/messages/messages_presenter.rb",100,30,18,18,0
"./app/reports/meeting_request_report.rb",100,54,29,29,0
"./app/reports/membership_request_report.rb",29,109,66,19,47
"./app/reports/mentor_request_report.rb",94,245,142,134,8
"./app/reports/mentoring_area_exporter.rb",92,663,404,371,33
"./app/reports/profile_exporter.rb",10,86,59,6,53
"./app/services/abstract_messages_filter_service.rb",94,126,67,63,4
"./app/services/abstract_request_service.rb",100,18,11,11,0
"./app/services/admin_messages_filter_service.rb",92,86,48,44,4
"./app/services/csv_response_headers_service.rb",100,29,15,15,0
"./app/services/get_member_from_name_with_email_service.rb",100,14,8,8,0
"./app/services/help_scout.rb",85,41,26,22,4
"./app/services/member_program_and_role_info_service.rb",100,34,22,22,0
"./app/services/membership_request_service.rb",97,106,64,62,2
"./app/services/mentor_request_service.rb",100,25,15,15,0
"./app/services/messages_filter_service.rb",100,38,21,21,0
"./app/services/organization_dashboard_service.rb",100,33,24,24,0
"./app/services/pagination_service.rb",100,31,11,11,0
"./app/services/project_request_service.rb",97,68,35,34,1
"./app/services/reorder_service.rb",100,14,8,8,0
"./app/services/security_setting_service.rb",100,10,6,6,0
"./app/services/three_sixty/survey_answer_service.rb",100,22,14,14,0
"./app/services/three_sixty/survey_service.rb",100,26,20,20,0
"./app/services/user_service.rb",94,70,31,29,2
"./lib/ChronusTerminologyVerifier/terminology_verifier.rb",100,76,48,48,0
"./lib/abstract_message_extensions.rb",100,41,17,17,0
"./lib/action_mailer_tls/smtp_tls.rb",17,72,46,8,38
"./lib/acts_as_rateable/acts_as_rateable.rb",75,100,44,33,11
"./lib/acts_as_rateable/rating.rb",83,18,6,5,1
"./lib/alert_grid/alert_grid.rb",63,33,16,10,6
"./lib/authenticated_system.rb",81,256,104,84,20
"./lib/authentication_for_external_services.rb",100,16,9,9,0
"./lib/authentication_models/model_auth.rb",95,42,22,21,1
"./lib/authentication_models/models/api_auth.rb",100,29,17,17,0
"./lib/authentication_models/models/bbnc_auth.rb",100,20,10,10,0
"./lib/authentication_models/models/cas_auth.rb",100,8,4,4,0
"./lib/authentication_models/models/chronus_auth.rb",100,44,26,26,0
"./lib/authentication_models/models/ldap_auth.rb",93,75,27,25,2
"./lib/authentication_models/models/openam_auth.rb",100,12,8,8,0
"./lib/authentication_models/models/openid_auth.rb",100,71,29,29,0
"./lib/authentication_models/models/openssl_auth.rb",86,26,14,12,2
"./lib/authentication_models/models/saml_auth.rb",76,93,17,13,4
"./lib/authentication_models/models/soap_auth.rb",89,34,19,17,2
"./lib/authentication_models/models/url_encryption_auth.rb",100,91,33,33,0
"./lib/authentication_models/program_specific_auth.rb",100,86,50,50,0
"./lib/authorization_manager/acts_as_role_based.rb",98,166,55,54,1
"./lib/authorization_manager/authorization_manager.rb",100,70,11,11,0
"./lib/authorization_manager/exceptions.rb",100,26,7,7,0
"./lib/authorization_manager/program_extensions.rb",100,58,20,20,0
"./lib/authorization_manager/user_extensions.rb",100,76,36,36,0
"./lib/auto_complete/auto_complete.rb",56,47,9,5,4
"./lib/auto_complete/auto_complete_macros_helper.rb",97,147,30,29,1
"./lib/back_mark/back_mark.rb",91,212,56,51,5
"./lib/base-auth/base_auth.rb",85,139,73,62,11
"./lib/chronus_integration_test.rb",27,246,124,33,91
"./lib/chronus_s3_utils.rb",42,40,26,11,15
"./lib/ckeditor/hooks/chronus.rb",55,52,22,12,10
"./lib/ckeditor_helpers_controllers.rb",60,19,10,6,4
"./lib/clam_scanner.rb",79,22,14,11,3
"./lib/clear_invalid_dependent_answers.rb",100,13,8,8,0
"./lib/common_controller_usages.rb",100,33,16,16,0
"./lib/common_profile_includes.rb",100,45,26,26,0
"./lib/connection_filters.rb",95,186,104,99,5
"./lib/country_codes/country_codes.rb",53,64,34,18,16
"./lib/cron_rake_runner.rb",100,34,16,16,0
"./lib/delayed_job_airbrake_logger.rb",83,11,6,5,1
"./lib/email_format_check.rb",100,11,7,7,0
"./lib/encryption_engine/aes.rb",100,29,21,21,0
"./lib/expose_sanitize.rb",67,6,3,2,1
"./lib/feature_manager/feature_manager.rb",100,145,38,38,0
"./lib/filter_utils.rb",80,138,84,67,17
"./lib/form_error_helper.rb",92,41,24,22,2
"./lib/generate_zip_file.rb",100,18,12,12,0
"./lib/geokit-rails/acts_as_mappable.rb",52,465,199,103,96
"./lib/geokit-rails/defaults.rb",100,22,6,6,0
"./lib/geokit-rails/ip_geocode_lookup.rb",61,46,18,11,7
"./lib/group_permissions.rb",100,23,11,11,0
"./lib/groups_filters.rb",99,252,167,165,2
"./lib/groups_report/groups_report.rb",100,281,155,155,0
"./lib/groups_report/groups_report_extensions.rb",98,138,59,58,1
"./lib/has_union/derived.rb",47,156,38,18,20
"./lib/has_union/has_union.rb",100,103,29,29,0
"./lib/health_metric/abstract_metric.rb",75,9,4,3,1
"./lib/health_metric/connectivity.rb",96,59,28,27,1
"./lib/health_metric/content_overview.rb",100,73,44,44,0
"./lib/health_metric/cumulative_report.rb",96,44,25,24,1
"./lib/health_metric/distributed_metric.rb",97,74,31,30,1
"./lib/health_metric/engagement.rb",96,166,78,75,3
"./lib/health_metric/growth.rb",92,168,79,73,6
"./lib/health_metric/health_report.rb",100,34,26,26,0
"./lib/health_metric/history_metric.rb",100,15,8,8,0
"./lib/health_metric/percent_metric.rb",97,147,69,67,2
"./lib/health_metric/program_health_report.rb",100,269,145,145,0
"./lib/iitmaa.rb",93,172,91,85,6
"./lib/import_linked_in.rb",89,94,38,34,4
"./lib/importers/user_importer.rb",94,376,255,239,16
"./lib/jobs/program_event_jobs.rb",93,24,14,13,1
"./lib/mailgun/chronus_mentor_mailgun.rb",100,18,13,13,0
"./lib/matching/custom_sql_query.rb",100,42,7,7,0
"./lib/matching/init.rb",100,1,1,1,0
"./lib/matching/lib/cache/refresh.rb",82,156,78,64,14
"./lib/matching/lib/client/client.rb",100,54,15,15,0
"./lib/matching/lib/common/configuration.rb",100,47,16,16,0
"./lib/matching/lib/indexer/indexer.rb",74,390,174,128,46
"./lib/matching/lib/matching.rb",100,12,7,7,0
"./lib/matching/lib/service/data_types/abstract_type.rb",93,234,67,62,5
"./lib/matching/lib/service/data_types/chronus_array.rb",100,51,22,22,0
"./lib/matching/lib/service/data_types/chronus_educations.rb",83,14,6,5,1
"./lib/matching/lib/service/data_types/chronus_experiences.rb",83,14,6,5,1
"./lib/matching/lib/service/data_types/chronus_location.rb",74,57,27,20,7
"./lib/matching/lib/service/data_types/chronus_manager.rb",93,32,15,14,1
"./lib/matching/lib/service/data_types/chronus_ordered_array.rb",87,49,23,20,3
"./lib/matching/lib/service/data_types/chronus_string.rb",95,43,22,21,1
"./lib/matching/lib/service/data_types/chronus_text.rb",85,41,20,17,3
"./lib/matching/lib/service/data_types/collection_type.rb",86,59,21,18,3
"./lib/matching/lib/service/interface/data_field.rb",94,48,17,16,1
"./lib/matching/lib/service/interface/document.rb",88,46,26,23,3
"./lib/matching/lib/service/persistence/data_field.rb",94,74,18,17,1
"./lib/matching/lib/service/persistence/document.rb",75,57,20,15,5
"./lib/matching/lib/service/persistence/score.rb",100,9,6,6,0
"./lib/matching/lib/service/persistence/setting.rb",100,10,7,7,0
"./lib/matching/lib/service/score_normalizer.rb",100,50,31,31,0
"./lib/matching/lib/service/service.rb",99,122,72,71,1
"./lib/meeting_mentor_suggest.rb",100,51,26,26,0
"./lib/mentoring_model_utils.rb",99,304,172,170,2
"./lib/mentoring_period_utils.rb",100,35,11,11,0
"./lib/my_form_builder.rb",96,89,53,51,2
"./lib/object_role_permission_extension/object_role_permission_extension.rb",100,47,29,29,0
"./lib/open_id_authentication.rb",56,148,73,41,32
"./lib/paperclip_processors/cropper.rb",80,19,10,8,2
"./lib/parallel_overrides.rb",78,45,27,21,6
"./lib/prawnto/action_controller.rb",48,46,25,12,13
"./lib/prawnto/action_view.rb",67,12,6,4,2
"./lib/prawnto/prawnto.rb",100,34,13,13,0
"./lib/prawnto/template_handler/compile_support.rb",44,74,36,16,20
"./lib/prawnto/template_handlers/base.rb",80,15,5,4,1
"./lib/prawnto/template_handlers/dsl.rb",80,16,5,4,1
"./lib/prawnto/template_handlers/raw.rb",29,64,28,8,20
"./lib/profile_question_extension.rb",100,102,14,14,0
"./lib/profile_role_question_extensions.rb",88,27,16,14,2
"./lib/push_notifier.rb",38,57,32,12,20
"./lib/remotipart_overrides.rb",80,18,10,8,2
"./lib/report/metrics_utils.rb",100,18,8,8,0
"./lib/report/sections_controller_utils.rb",100,9,5,5,0
"./lib/rsa_helper.rb",64,43,25,16,9
"./lib/safe_mass_assignment/safe_mass_assignment.rb",100,55,34,34,0
"./lib/safe_mass_assignment/safe_mass_assignment_proxy.rb",100,20,12,12,0
"./lib/security_setting_methods.rb",100,28,15,15,0
"./lib/sub_programs/init.rb",100,7,4,4,0
"./lib/sub_programs/routing.rb",57,29,14,8,6
"./lib/sub_programs/routing_extensions.rb",50,9,6,3,3
"./lib/tab_configuration.rb",98,85,41,40,1
"./lib/tasks/data_importer/import_users_v2.rake",50,13,8,4,4
"./lib/tasks/feed_migrator.rake",52,202,124,64,60
"./lib/tasks/feed_migrator/bbva.rb",93,277,178,166,12
"./lib/tasks/feed_migrator/daimler.rb",93,267,145,135,10
"./lib/tasks/feed_migrator/frbny.rb",93,297,208,193,15
"./lib/tasks/feed_migrator/lsi.rb",98,204,141,138,3
"./lib/tasks/feed_migrator/nara.rb",96,206,143,137,6
"./lib/tasks/feed_migrator/rockwell_collins.rb",85,223,138,117,21
"./lib/tasks/feed_migrator/staples.rb",96,206,143,137,6
"./lib/tasks/meeting_porter.rb",79,46,29,23,6
"./lib/tasks/mentoring_model_migrator.rake",52,469,283,146,137
"./lib/translations_service.rb",100,58,37,37,0
"./lib/url_for_helper.rb",100,23,9,9,0
"./lib/user_dependencies.rb",100,154,58,58,0
"./lib/user_listing_extensions.rb",99,175,92,91,1
"./lib/white_list/white_list_helper.rb",47,97,43,20,23
"./vendor/engines/campaign_management/app/controllers/campaign_management/campaign_messages_controller.rb",86,149,92,79,13
"./vendor/engines/campaign_management/app/controllers/campaign_management/campaigns_controller.rb",89,182,109,97,12
"./vendor/engines/campaign_management/app/helpers/campaign_management/campaigns_helper.rb",96,239,106,102,4
"./vendor/engines/campaign_management/app/models/campaign_management/campaign.rb",98,229,118,116,2
"./vendor/engines/campaign_management/app/models/campaign_management/campaign_activation_validator.rb",100,7,4,4,0
"./vendor/engines/campaign_management/app/models/campaign_management/campaign_analytics_synchronizer.rb",96,58,27,26,1
"./vendor/engines/campaign_management/app/models/campaign_management/campaign_message.rb",100,94,44,44,0
"./vendor/engines/campaign_management/app/models/campaign_management/campaign_message_analytics.rb",80,31,15,12,3
"./vendor/engines/campaign_management/app/models/campaign_management/campaign_message_observer.rb",100,12,7,7,0
"./vendor/engines/campaign_management/app/models/campaign_management/campaign_message_user_job.rb",100,9,6,6,0
"./vendor/engines/campaign_management/app/models/campaign_management/campaign_observer.rb",100,16,9,9,0
"./vendor/engines/campaign_management/app/models/campaign_management/campaign_presenter.rb",96,93,53,51,2
"./vendor/engines/campaign_management/app/models/campaign_management/campaign_processor.rb",100,31,18,18,0
"./vendor/engines/campaign_management/app/models/campaign_management/campaign_user_status.rb",100,10,6,6,0
"./vendor/engines/campaign_management/app/models/campaign_management/destroy_campaign_jobs.rb",100,11,7,7,0
"./vendor/engines/campaign_management/app/models/campaign_management/email_event_log.rb",100,50,21,21,0
"./vendor/engines/campaign_management/app/models/campaign_management/email_event_log_observer.rb",100,24,15,15,0
"./vendor/engines/campaign_management/app/models/campaign_management/exceptions.rb",100,10,4,4,0
"./vendor/engines/campaign_management/app/models/campaign_management/process_campaigns_job.rb",100,10,6,6,0
"./vendor/engines/campaign_management/app/models/campaign_management/send_campaign_message_job.rb",100,63,31,31,0
"./vendor/engines/campaign_management/app/models/campaign_management/user_campaign_log.rb",100,70,43,43,0
"./vendor/engines/campaign_management/lib/campaign_management.rb",100,4,2,2,0
"./vendor/engines/campaign_management/lib/campaign_management/engine.rb",100,19,10,10,0
"./vendor/engines/chronus_mentor_api/app/controllers/api/v2/basic_controller.rb",100,31,18,18,0
"./vendor/engines/chronus_mentor_api/app/controllers/api/v2/connection_profile_fields_controller.rb",100,16,9,9,0
"./vendor/engines/chronus_mentor_api/app/controllers/api/v2/connections_controller.rb",100,44,21,21,0
"./vendor/engines/chronus_mentor_api/app/controllers/api/v2/mentoring_templates_controller.rb",100,16,9,9,0
"./vendor/engines/chronus_mentor_api/app/controllers/api/v2/profile_fields_controller.rb",100,16,9,9,0
"./vendor/engines/chronus_mentor_api/app/controllers/api/v2/users_controller.rb",100,44,21,21,0
"./vendor/engines/chronus_mentor_api/app/controllers/api_tests_controller.rb",100,79,64,64,0
"./vendor/engines/chronus_mentor_api/app/controllers/mobile_api/v1/admin_messages_controller.rb",100,28,16,16,0
"./vendor/engines/chronus_mentor_api/app/controllers/mobile_api/v1/announcements_controller.rb",100,15,8,8,0
"./vendor/engines/chronus_mentor_api/app/controllers/mobile_api/v1/basic_controller.rb",95,81,44,42,2
"./vendor/engines/chronus_mentor_api/app/controllers/mobile_api/v1/groups_controller.rb",92,36,25,23,2
"./vendor/engines/chronus_mentor_api/app/controllers/mobile_api/v1/members_controller.rb",100,14,11,11,0
"./vendor/engines/chronus_mentor_api/app/controllers/mobile_api/v1/membership_requests_controller.rb",100,46,29,29,0
"./vendor/engines/chronus_mentor_api/app/controllers/mobile_api/v1/mentor_requests_controller.rb",97,125,70,68,2
"./vendor/engines/chronus_mentor_api/app/controllers/mobile_api/v1/mentoring_area_controller.rb",100,50,25,25,0
"./vendor/engines/chronus_mentor_api/app/controllers/mobile_api/v1/mentoring_templates_controller.rb",100,17,10,10,0
"./vendor/engines/chronus_mentor_api/app/controllers/mobile_api/v1/messages_controller.rb",86,73,42,36,6
"./vendor/engines/chronus_mentor_api/app/controllers/mobile_api/v1/passwords_controller.rb",100,13,9,9,0
"./vendor/engines/chronus_mentor_api/app/controllers/mobile_api/v1/programs_controller.rb",100,28,17,17,0
"./vendor/engines/chronus_mentor_api/app/controllers/mobile_api/v1/resources_controller.rb",100,21,13,13,0
"./vendor/engines/chronus_mentor_api/app/controllers/mobile_api/v1/scraps_controller.rb",92,80,50,46,4
"./vendor/engines/chronus_mentor_api/app/controllers/mobile_api/v1/sessions_controller.rb",100,79,39,39,0
"./vendor/engines/chronus_mentor_api/app/controllers/mobile_api/v1/tasks_controller.rb",100,33,21,21,0
"./vendor/engines/chronus_mentor_api/app/controllers/mobile_api/v1/users_controller.rb",100,24,15,15,0
"./vendor/engines/chronus_mentor_api/app/helpers/mobile_api/v1/application_helper.rb",97,78,33,32,1
"./vendor/engines/chronus_mentor_api/app/helpers/mobile_api/v1/mentor_request_helper.rb",100,11,9,9,0
"./vendor/engines/chronus_mentor_api/app/helpers/mobile_api/v1/messages_helper.rb",84,84,50,42,8
"./vendor/engines/chronus_mentor_api/app/helpers/mobile_api/v1/tasks_helper.rb",100,38,21,21,0
"./vendor/engines/chronus_mentor_api/app/models/api/v2/base_presenter.rb",100,61,25,25,0
"./vendor/engines/chronus_mentor_api/app/models/api/v2/connection_profile_fields_presenter.rb",100,18,7,7,0
"./vendor/engines/chronus_mentor_api/app/models/api/v2/connections_presenter.rb",98,263,124,122,2
"./vendor/engines/chronus_mentor_api/app/models/api/v2/mentoring_template_presenter.rb",100,22,9,9,0
"./vendor/engines/chronus_mentor_api/app/models/api/v2/profile_fields_presenter.rb",100,35,15,15,0
"./vendor/engines/chronus_mentor_api/app/models/api/v2/users_presenter.rb",91,251,121,110,11
"./vendor/engines/chronus_mentor_api/app/models/mobile_api/v1/base_presenter.rb",100,63,26,26,0
"./vendor/engines/chronus_mentor_api/app/models/mobile_api/v1/groups_presenter.rb",100,51,14,14,0
"./vendor/engines/chronus_mentor_api/app/models/mobile_api/v1/mentoring_template_presenter.rb",100,22,9,9,0
"./vendor/engines/chronus_mentor_api/app/models/mobile_api/v1/resources_presenter.rb",100,39,18,18,0
"./vendor/engines/chronus_mentor_api/app/models/mobile_api/v1/users_presenter.rb",96,286,136,130,6
"./vendor/engines/chronus_mentor_api/lib/chronus_mentor_api.rb",100,4,2,2,0
"./vendor/engines/chronus_mentor_api/lib/chronus_mentor_api/authentication_utils.rb",100,16,10,10,0
"./vendor/engines/chronus_mentor_api/lib/chronus_mentor_api/engine.rb",100,5,3,3,0
"./vendor/engines/chronus_mentor_api/lib/chronus_mentor_api/mobile_api/common_parameters.rb",100,115,56,56,0
"./vendor/engines/chronus_translations/app/controllers/languages_controller.rb",100,89,35,35,0
"./vendor/engines/chronus_translations/app/controllers/organization_languages_controller.rb",100,73,44,44,0
"./vendor/engines/chronus_translations/app/helpers/languages_helper.rb",68,73,37,25,12
"./vendor/engines/chronus_translations/app/helpers/organization_languages_helper.rb",83,29,12,10,2
"./vendor/engines/chronus_translations/app/models/language.rb",100,79,39,39,0
"./vendor/engines/chronus_translations/app/models/member_language.rb",100,7,5,5,0
"./vendor/engines/chronus_translations/app/models/organization_language.rb",100,8,6,6,0
"./vendor/engines/chronus_translations/lib/chronus_translations.rb",100,4,2,2,0
"./vendor/engines/chronus_translations/lib/chronus_translations/engine.rb",100,9,5,5,0
